bb.gem.m0.chanmap = 
     20      11       7       3       0       3      29       1       1 
     20      11       7       3       1       2      28       1       1 
     20      11       7       3       2       1      27       1       1 
     20      11       7       3       3       0      26       1       1 
     20      11       7       3       4       7      25       1       1 
     20      11       7       3       5       6      24       1       1 
     20      11       7       3       6       5      23       1       1 
     20      11       7       3       7       4      22       1       1 
     20      11       7       3       8      11      21       1       1 
     20      11       7       3       9      10      20       1       1 
     20      11       7       3      10       9      19       1       1 
     20      11       7       3      11       8      18       1       1 
     20      11       7       3      12      15      17       1       1 
     20      11       7       3      13      14      16       1       1 
     20      11       7       3      14      13      15       1       1 
     20      11       8       3       0       3      11       1       1 
     20      11       8       3       1       2      10       1       1 
     20      11       8       3       2       1       9       1       1 
     20      11       8       3       3       0       8       1       1 
     20      11       8       3       4       7       7       1       1 
     20      11       8       3       5       6       6       1       1 
     20      11       8       3       6       5       5       1       1 
     20      11       8       3       7       4       4       1       1 
     20      11       8       3       8      11       3       1       1 
     20      11       8       3       9      10       2       1       1 
     20      11       8       3      10       9       1       1       1 
     20      11       8       3      11       8       0       1       1 
     20      11       8       3      12      15      14       1       1 
     20      11       8       3      13      14      13       1       1 
     20      11       8       3      14      13      12       1       1 
     20      11       9       3       0       3      26       0       0 
     20      11       9       3       1       2      27       0       0 
     20      11       9       3       2       1      28       0       0 
     20      11       9       3       3       0      29       0       0 
     20      11       9       3       4       7      22       0       0 
     20      11       9       3       5       6      23       0       0 
     20      11       9       3       6       5      24       0       0 
     20      11       9       3       7       4      25       0       0 
     20      11       9       3       8      11      18       0       0 
     20      11       9       3       9      10      19       0       0 
     20      11       9       3      10       9      20       0       0 
     20      11       9       3      11       8      21       0       0 
     20      11       9       3      12      15      15       0       0 
     20      11       9       3      13      14      16       0       0 
     20      11       9       3      14      13      17       0       0 
     20      11      10       3       0       3       8       0       0 
     20      11      10       3       1       2       9       0       0 
     20      11      10       3       2       1      10       0       0 
     20      11      10       3       3       0      11       0       0 
     20      11      10       3       4       7       4       0       0 
     20      11      10       3       5       6       5       0       0 
     20      11      10       3       6       5       6       0       0 
     20      11      10       3       7       4       7       0       0 
     20      11      10       3       8      11       0       0       0 
     20      11      10       3       9      10       1       0       0 
     20      11      10       3      10       9       2       0       0 
     20      11      10       3      11       8       3       0       0 
     20      11      10       3      12      15      12       0       0 
     20      11      10       3      13      14      13       0       0 
     20      11      10       3      14      13      14       0       0 
bb.gem.m1.chanmap = 
     20      11      16      24       0       0       9       0       0 
     20      11      16      24       1       1       7       0       0 
     20      11      16      24       2       2       5       0       0 
     20      11      16      24       3       3       3       0       0 
     20      11      16      24       4       4       1       0       0 
     20      11      17      24       4       0       7       0       1 
     20      11      17      24       3       1       5       0       1 
     20      11      17      24       2       2       3       0       1 
     20      11      17      24       1       3       1       0       1 
     20      11      18      24       0       0       0       1       0 
     20      11      18      24       1       1       2       1       0 
     20      11      18      24       2       2       4       1       0 
     20      11      18      24       3       3       6       1       0 
     20      11      18      24       4       4       8       1       0 
     20      11      19      24       0       0       0       1       1 
     20      11      19      24       1       1       2       1       1 
     20      11      19      24       2       2       4       1       1 
     20      11      19      24       3       3       6       1       1 
bb.gem.m2.chanmap = 
     20      11      16      15       5       8       9       0       0 
     20      11      16      15       6       9       7       0       0 
     20      11      16      15       7      10       5       0       0 
     20      11      16      15       8      11       3       0       0 
     20      11      16      15       9      12       1       0       0 
     20      11      17      15       9       8       7       0       1 
     20      11      17      15       8       9       5       0       1 
     20      11      17      15       7      10       3       0       1 
     20      11      17      15       6      11       1       0       1 
     20      11      18      15       5       8       0       1       0 
     20      11      18      15       6       9       2       1       0 
     20      11      18      15       7      10       4       1       0 
     20      11      18      15       8      11       6       1       0 
     20      11      18      15       9      12       8       1       0 
     20      11      19      15       9       8       0       1       1 
     20      11      19      15       8       9       2       1       1 
     20      11      19      15       7      10       4       1       1 
     20      11      19      15       6      11       6       1       1 
bb.gem.m3.chanmap = 
     20      11      16      12      10      16       9       0       0 
     20      11      16      12      11      17       7       0       0 
     20      11      16      12      12      18       5       0       0 
     20      11      16      12      13      19       3       0       0 
     20      11      16      12      14      20       1       0       0 
     20      11      17      12      10      16       7       0       1 
     20      11      17      12      11      17       5       0       1 
     20      11      17      12      12      18       3       0       1 
     20      11      17      12      13      19       1       0       1 
     20      11      18      12      10      16       0       1       0 
     20      11      18      12      11      17       2       1       0 
     20      11      18      12      12      18       4       1       0 
     20      11      18      12      13      19       6       1       0 
     20      11      18      12      14      20       8       1       0 
     20      11      19      12      14      16       0       1       1 
     20      11      19      12      13      17       2       1       1 
     20      11      19      12      12      18       4       1       1 
     20      11      19      12      11      19       6       1       1 
bb.gem.m4.chanmap = 
     20      11      11     104       0       3      29       1       1 
     20      11      11     104       1       2      28       1       1 
     20      11      11     104       2       1      27       1       1 
     20      11      11     104       3       0      26       1       1 
     20      11      11     104       4       7      25       1       1 
     20      11      11     104       5       6      24       1       1 
     20      11      11     104       6       5      23       1       1 
     20      11      11     104       7       4      22       1       1 
     20      11      11     104       8      11      21       1       1 
     20      11      11     104       9      10      20       1       1 
     20      11      11     104      10       9      19       1       1 
     20      11      11     104      11       8      18       1       1 
     20      11      11     104      12      15      17       1       1 
     20      11      11     104      13      14      16       1       1 
     20      11      11     104      14      13      15       1       1 
     20      11      12     104       0       3      11       1       1 
     20      11      12     104       1       2      10       1       1 
     20      11      12     104       2       1       9       1       1 
     20      11      12     104       3       0       8       1       1 
     20      11      12     104       4       7       7       1       1 
     20      11      12     104       5       6       6       1       1 
     20      11      12     104       6       5       5       1       1 
     20      11      12     104       7       4       4       1       1 
     20      11      12     104       8      11       3       1       1 
     20      11      12     104       9      10       2       1       1 
     20      11      12     104      10       9       1       1       1 
     20      11      12     104      11       8       0       1       1 
     20      11      12     104      12      15      14       1       1 
     20      11      12     104      13      14      13       1       1 
     20      11      12     104      14      13      12       1       1 
     20      11      13     104       0       3      26       0       0 
     20      11      13     104       1       2      27       0       0 
     20      11      13     104       2       1      28       0       0 
     20      11      13     104       3       0      29       0       0 
     20      11      13     104       4       7      22       0       0 
     20      11      13     104       5       6      23       0       0 
     20      11      13     104       6       5      24       0       0 
     20      11      13     104       7       4      25       0       0 
     20      11      13     104       8      11      18       0       0 
     20      11      13     104       9      10      19       0       0 
     20      11      13     104      10       9      20       0       0 
     20      11      13     104      11       8      21       0       0 
     20      11      13     104      12      15      15       0       0 
     20      11      13     104      13      14      16       0       0 
     20      11      13     104      14      13      17       0       0 
     20      11      14     104       0       3       8       0       0 
     20      11      14     104       1       2       9       0       0 
     20      11      14     104       2       1      10       0       0 
     20      11      14     104       3       0      11       0       0 
     20      11      14     104       4       7       4       0       0 
     20      11      14     104       5       6       5       0       0 
     20      11      14     104       6       5       6       0       0 
     20      11      14     104       7       4       7       0       0 
     20      11      14     104       8      11       0       0       0 
     20      11      14     104       9      10       1       0       0 
     20      11      14     104      10       9       2       0       0 
     20      11      14     104      11       8       3       0       0 
     20      11      14     104      12      15      12       0       0 
     20      11      14     104      13      14      13       0       0 
     20      11      14     104      14      13      14       0       0 
bb.gem.m5.chanmap = 
     20      11      20     102       0       3      29       1       1 
     20      11      20     102       1       2      28       1       1 
     20      11      20     102       2       1      27       1       1 
     20      11      20     102       3       0      26       1       1 
     20      11      20     102       4       7      25       1       1 
     20      11      20     102       5       6      24       1       1 
     20      11      20     102       6       5      23       1       1 
     20      11      20     102       7       4      22       1       1 
     20      11      20     102       8      11      21       1       1 
     20      11      20     102       9      10      20       1       1 
     20      11      20     102      10       9      19       1       1 
     20      11      20     102      11       8      18       1       1 
     20      11      20     102      12      15      17       1       1 
     20      11      20     102      13      14      16       1       1 
     20      11      20     102      14      13      15       1       1 
     20      11      21     102       0       3      11       1       1 
     20      11      21     102       1       2      10       1       1 
     20      11      21     102       2       1       9       1       1 
     20      11      21     102       3       0       8       1       1 
     20      11      21     102       4       7       7       1       1 
     20      11      21     102       5       6       6       1       1 
     20      11      21     102       6       5       5       1       1 
     20      11      21     102       7       4       4       1       1 
     20      11      21     102       8      11       3       1       1 
     20      11      21     102       9      10       2       1       1 
     20      11      21     102      10       9       1       1       1 
     20      11      21     102      11       8       0       1       1 
     20      11      21     102      12      15      14       1       1 
     20      11      21     102      13      14      13       1       1 
     20      11      21     102      14      13      12       1       1 
     20      11      22     102       0       3      26       0       0 
     20      11      22     102       1       2      27       0       0 
     20      11      22     102       2       1      28       0       0 
     20      11      22     102       3       0      29       0       0 
     20      11      22     102       4       7      22       0       0 
     20      11      22     102       5       6      23       0       0 
     20      11      22     102       6       5      24       0       0 
     20      11      22     102       7       4      25       0       0 
     20      11      22     102       8      11      18       0       0 
     20      11      22     102       9      10      19       0       0 
     20      11      22     102      10       9      20       0       0 
     20      11      22     102      11       8      21       0       0 
     20      11      22     102      12      15      15       0       0 
     20      11      22     102      13      14      16       0       0 
     20      11      22     102      14      13      17       0       0 
     20      11      23     102       0       3       8       0       0 
     20      11      23     102       1       2       9       0       0 
     20      11      23     102       2       1      10       0       0 
     20      11      23     102       3       0      11       0       0 
     20      11      23     102       4       7       4       0       0 
     20      11      23     102       5       6       5       0       0 
     20      11      23     102       6       5       6       0       0 
     20      11      23     102       7       4       7       0       0 
     20      11      23     102       8      11       0       0       0 
     20      11      23     102       9      10       1       0       0 
     20      11      23     102      10       9       2       0       0 
     20      11      23     102      11       8       3       0       0 
     20      11      23     102      12      15      12       0       0 
     20      11      23     102      13      14      13       0       0 
     20      11      23     102      14      13      14       0       0 
bb.gem.m6.chanmap = 
     20      11       0      13       0      15       0       1       1 
     20      11       0      13       1      14       1       1       1 
     20      11       0      13       2      13       2       1       1 
     20      11       0      13       3      12       3       1       1 
     20      11       0      13       4      11       4       1       1 
     20      11       0      13       5      10       5       1       1 
     20      11       0      13       6       9       6       1       1 
     20      11       0      13       7       8       7       1       1 
     20      11       0      13       8       7       8       1       1 
     20      11       0      13       9       6       9       1       1 
     20      11       0      13      10       5      10       1       1 
     20      11       0      13      11       4      11       1       1 
     20      11       4      13      10       4       9       1       0 
     20      11       4      13      11       3       8       1       0 
     20      11       4      13      12       2       7       1       0 
     20      11       4      13      13       1       6       1       0 
     20      11       4      13      14       0       5       1       0 
     20      11       5      13       0       4       0       0       0 
     20      11       5      13       1       3       1       0       0 
     20      11       5      13       2       2       2       0       0 
     20      11       5      13       3       1       3       0       0 
     20      11       5      13       4       0       4       0       0 
bb.gem.m7.chanmap = 
     20      11       1      20       0      15       0       1       1 
     20      11       1      20       1      14       1       1       1 
     20      11       1      20       2      13       2       1       1 
     20      11       1      20       3      12       3       1       1 
     20      11       1      20       4      11       4       1       1 
     20      11       1      20       5      10       5       1       1 
     20      11       1      20       6       9       6       1       1 
     20      11       1      20       7       8       7       1       1 
     20      11       1      20       8       7       8       1       1 
     20      11       1      20       9       6       9       1       1 
     20      11       1      20      10       5      10       1       1 
     20      11       1      20      11       4      11       1       1 
     20      11       4      20       5      12       9       1       0 
     20      11       4      20       6      11       8       1       0 
     20      11       4      20       7      10       7       1       0 
     20      11       4      20       8       9       6       1       0 
     20      11       4      20       9       8       5       1       0 
     20      11       5      20       5      12       0       0       0 
     20      11       5      20       6      11       1       0       0 
     20      11       5      20       7      10       2       0       0 
     20      11       5      20       8       9       3       0       0 
     20      11       5      20       9       8       4       0       0 
bb.gem.m8.chanmap = 
     20      11       2      17       0      15      11       0       1 
     20      11       2      17       1      14      10       0       1 
     20      11       2      17       2      13       9       0       1 
     20      11       2      17       3      12       8       0       1 
     20      11       2      17       4      11       7       0       1 
     20      11       2      17       5      10       6       0       1 
     20      11       2      17       6       9       5       0       1 
     20      11       2      17       7       8       4       0       1 
     20      11       2      17       8       7       3       0       1 
     20      11       2      17       9       6       2       0       1 
     20      11       2      17      10       5       1       0       1 
     20      11       2      17      11       4       0       0       1 
     20      11       4      17       0      20       9       1       0 
     20      11       4      17       1      19       8       1       0 
     20      11       4      17       2      18       7       1       0 
     20      11       4      17       3      17       6       1       0 
     20      11       4      17       4      16       5       1       0 
     20      11       5      17      10      20       0       0       0 
     20      11       5      17      11      19       1       0       0 
     20      11       5      17      12      18       2       0       0 
     20      11       5      17      13      17       3       0       0 
     20      11       5      17      14      16       4       0       0 
bb.gem.m9.chanmap = 
     20      11       3      25       0      15      11       0       1 
     20      11       3      25       1      14      10       0       1 
     20      11       3      25       2      13       9       0       1 
     20      11       3      25       3      12       8       0       1 
     20      11       3      25       4      11       7       0       1 
     20      11       3      25       5      10       6       0       1 
     20      11       3      25       6       9       5       0       1 
     20      11       3      25       7       8       4       0       1 
     20      11       3      25       8       7       3       0       1 
     20      11       3      25       9       6       2       0       1 
     20      11       3      25      10       5       1       0       1 
     20      11       3      25      11       4       0       0       1 
     20      11       6      25       0       4       9       1       0 
     20      11       6      25       1       3       8       1       0 
     20      11       6      25       2       2       7       1       0 
     20      11       6      25       3       1       6       1       0 
     20      11       6      25       4       0       5       1       0 
     20      11       6      25       8      12       0       0       0 
     20      11       6      25       9      11       1       0       0 
     20      11       6      25      10      10       2       0       0 
     20      11       6      25      11       9       3       0       0 
     20      11       6      25      12       8       4       0       0 
